40 40
 1  1  1  1  1  1  0  0  0  0  0  0  1  1  0  1  1  1  1  1  1  1  1  1  1  1  1  1  1  1  1  1  1  1  1  1  1  1  1  1 
 1  1  1  1  1  1  1  1  1  1  1  1  1  1  1  1  1  1  1  1  1  1  1  1  1  1  1  1  1  1  1  1  1  1  1  1  1  1  1  1 
 1  1  1  1  1  1  1  1  1  1  1  1  1  1  1  1  1  1  1  1  1  1  1  1  1  1  1  1  1  1  1  1  1  1  1  1  1  1  1  1 
 1  1  1  1  1  1  1  1  1  1  1  1  1  1  1  1  1  1  1  1  1  1  1  1  1  1  1  1  1  1  1  1  1  1  1  1  1  1  1  1 
 1  1  1  1  1  1  1  0  0  1  1  1  1  1  1  1  1  1  0  0  0  0  0  0  0  0  0  1  1  1  1  1  1  0  0  0  1  1  1  1 
 3  3  3  4  0  0  0  0  0  0  0  0  0  0  0  0  1  0  0  0  0  0  0  0  0  0  0  0  0  0  0  0  0  0  0  0 10  3  3  3 
11 11 11  5  0  0  0  0  0  0  0  0  1  0  0  0  0  0  0  0  0  0  0  0  0  0  0  0  0  0  0  0  0  0  0  0  9 11 11 11 
13 11 11  5  0  0  0  0  0  0  0  0  0  0  0  0  0  0  0  0  0  0  0  0  0  0  0  0  0  0  0  0  0  0  0  0  9 11 12 11 
11 11 11  5  0  0  0  0  0  0  0  0  0  0  0  0  0  0  0  0  0  0  0  0  0  0  0  0  0  0  0  0  0  0  0  0  9 11 13 11 
13 12 11  5  0  0  0  0 10  2  2  6 18 18 18 18 18 18 18 18 18 18 18 18 18 18 18  2  2  2  2  0  0  0  0 22  9 11 11 11 
11 11 11  5  0  0  0  0  9  5  0  0  0  0  0  0  0  0  0  0  0  0  0  0  0  0  0  0  0  0  0  0  0  0  0  0  9 11 13 11 
11 11 11  5  0  0  0  0  9  5  0  0  0  0  0  0  0  0  0  0  0  0  0  0  0  0  0  0  0  0  0  0  0  0  0  0  9 11 13 11 
13 11 11  5  0  0  0  0  9  5  0  0  0  0  0  0  0  0  0  0  0  0  0  0  0  0  0  0  0  0  0  0  0  0  0 22  9 13 11 11 
11 11 11  5  0  0  7  7  7  6  0  0  0  0  0  0  0  0  0  0  0  0  0  0  0  0  0  0  0  0  0  0  0  0  0  0  9 11 11 12 
13 12 11  5  0  0  0  0  0  0  0  0  0  0  0  0  0  0  0  0  0  0  0  0  0  0  0  0  0  0  0  0  0  0  0  0  9 12 11 11 
11 11 11  5  0  0  0  0  0  0  0  0 10  2  2  2  2  4  0  0  0  0  0 10  2  2  2  2  2  2  4  0  0  0  0 22  9 13 13 11 
11 11 13 13  7  0  0  0  0  0  0  0  9 12 12 12 12 12  2  2  2  2  2 12 12 12 12 12 12 12  6  0  0  0  0  0  9 11 11 11 
11 11 11  5  0  0  0  0  2  2  2  2  6  0  0  0  0  0  0  0  0  0  0  0  0  0  0  0  0  0  0  0  0  0  0  0  9 11 12 11 
11 11 12  5  0  0  0  0  0  0  0  0  0  0  0  0  0  0  0  0 34  0  0  0  0  0  0  0  0  0  0  0  0  0  0 22  9 11 13 13 
13 11 11  5  0  0  0  0  0  0  0  0  0  0  0  0  0  0  0  0  0  0  0  0  0  0  0  0  0  0  0  0  0  0  0  0  9 11 13 11 
13 11 11 11  7  7  0  0  0  0  0  0  0  0  0  0  0  0  0  0  0  0  0  0  0  0  0  0  0  0  0  0  0  0  0  0  9 12 11 11 
11 11 11  5  0  0  0  0  0  0  0  0  0  0  0  0  0  0  0  0  0  0  0  0  0  0  0  0  0  0  0  0  0  0  0 22  9 11 11 11 
11 11 11  5  0  0  0  0  0  0  0  0  0  0  0  0  0  0  0  0  0  0  0  0  0  0  0  0  0  0  0  0  0  0  0  0  9 11 11 12 
11 11 13  5  0  0  0  0 10  3  3  5 18 18 18 18 18 18 18 18  9  3  3 17  0  0  0  0  0  0  0  0  0  0  0  0  9 11 11 11 
11 11 11  5  0  0  0  0  8  7  7  6  0  0  0  0  0  0  0  0  8  7  7  6  0  0  0  0  0  0  0  0  0  0  0 22  9 11 11 13 
11 11 11  5  0  0  0  0  0  0  0  0  0  0  0  0  0  0  0  0  0  0  0  0  0  0  0  0  0  0  0  0  0  0  0  0  9 11 11 11 
11 12 11 11  7  7  0  0  0  0  0  0  0  0  0  0  0  0  0  0  0  0  0  0  0  0  0  0  0  0  0  0  0  0  0  0  9 13 11 11 
11 11 11  5  0  0  0  0  0  0 35  0  0  0  0  0  0  0  0  0  0 10  3  3  3  4  0  0  0  0  0  0  0  0  0 22  9 12 11 11 
13 11 11  5  0  0  0  0  0  0  0  0  0  0  0  0  0  0  0  0  0  9 11 11 11  5  0  0  0  0  0  0  0  0  0  0  9 11 11 11 
11 11 13  5  0  0  0  0  0  0  0  0  0  0  0  0  0  0  0  8 12 13 11 12 11  5  0  0  0  0  0  0  0  0  0  0  9 11 11 11 
11 11 11 11  7  7  7  0  0  0  0  0  0  0  0  0  0  0  0  0  9 11 11 11 12 11  3  3  3  3  3  4  0  0  0  0  9 11 13 11 
11 11 11 11  0  0  0  0  0  0  0  0  0  0  0  0  0  0  0  0  9 12 11 13 11 11 11 12 11 11 11  5  0  0  0  0  9 11 11 11 
11 11 12  5  0  0  0  0  0  7  7  7  7  7  7  7  7  7  0  0  9 11  7  7  7  7  7  7  7 16 11  5  0  0  0 10 14 11 11 11 
11 11 11  5  0  0  0  0  0  0  0  0  0  0  0  0  0  0  0  0  9  5  0  0  0  0  0  0  0  9 11  5  0  0  0  8 11 11 13 11 
11 11 11  5  0  0  0  0  0  0  0  0  0  0  0  0  0  0  0  0  8  6  0  0  0  0  0  0  0  9 12  5  0  0  0  0  9 11 11 11 
11 11 11  5  0  0  0  0  0  0  0  0  0  0  0  0  0  0  0  0  0  0  0  0  0  0  0  0  0  9 11  5  0  0  0  0  9 11 11 11 
13 11 11 15  3  3  2  3  3  2  3  2  3  3  2  2  2  3  3  2  3  3  2  2  2  3  3  2  2  3  3  3  2  2  2  3 14 11 11 11 
11 11 12 11 11 11 11 11 11 11 11 11 13 11 11 11 12 11 11 11 11 11 11 11 11 13 11 11 11 11 11 11 11 11 11 11 13 11 11 11 
11 11 11 11 11 11 11 13 11 12 11 11 11 13 11 11 11 11 11 11 11 11 11 12 11 11 11 11 12 11 13 11 11 12 12 11 11 11 11 11 
11 11 11 11 11 13 11 11 11 11 11 11 11 11 11 11 11 11 11 11 11 11 11 11 11 13 13 11 11 11 11 11 11 11 11 11 11 11 11 11 
 0  0  0  0  0  0  0  0  0  0  0  0  0  0  0  0  0  0  0  0  0  0  0  0  0  0  0  0  0  0  0  0  0  0  0  0  0  0  0  0 
 0  0  0  0  0  0  0  0  0  0  0  0  0  0  0  0  0  0  0  0  0  0  0  0  0  0  0  0  0  0  0  0  0  0  0  0  0  0  0  0 
 0  0  0  0  0  0  0  0  0  0  0  0  0  0  0  0  0  0  0  0  0  0  0  0  0  0  0  0  0  0  0  0  0  0  0  0  0  0  0  0 
 0  0  0  0  0  0  0  0  0  0  0  0  0  0  0  0  0  0  0  0  0  0  0  0  0  0  0  0  0  0  0  0  0  0  0  0  0  0  0  0 
 0  0  0  0  0  0  0  0  0  0  0  0  0  0  0  0  0  0  0  0  0  0  0  0  0  0  0  0  0  0  0  0  0  0  0  0  0  0  0  0 
 0  0  0  0  0  0  0  0  0  0  0  0  0  0  0  0  0  0  0  0  0  0  0  0  0  0  0  0  0  0  0  0  0  0  0  0  0  0  0  0 
 0  0  0  0  0  0  0  0  0  0  0  0  0  0  0  0  0  0  0  0  0  0  0  0  0  0  0  0  0  0  0  0  0  0  0  0  0  0  0  0 
 0  0  0  0  0  0  0  0  0  0  0  0  0  0  0  0  0  0  0  0  0  0  0  0  0  0  0  0  0  0  0  0  0  0  0  0  0  0  0  0 
 0  0  0  0  0  0  0  0  0  0 28 30  0  0  0  0  0  0  0  0  0  0  0  0  0  0  0 29  0  0  0  0  0  0  0  0  0  0  0  0 
 0  0  0  0  0  0  0  0  0 20 20 20  0  0  0  0  0  0  0  0  0  0  0  0  0  0  0 20 20 20 20  0  0  0  0  0  0  0  0  0 
 0  0  0  0  0  0  0  0  0  0  0  0  0  0  0  0  0  0  0  0  0  0  0  0  0 34  0  0  0  0  0  0  0  0  0  0  0  0  0  0 
 0  0  0  0  0  0  0  0  0  0  0  0  0  0  0  0  0  0  0  0  0  0  0  0  0  0  0  0  0  0  0  0  0  0  0  0  0  0  0  0 
 0  0  0  0  0  0  0  0  0  0  0  0  0  0  0  0  0  0  0  0  0  0  0  0  0  0  0  0  0  0  0  0  0  0  0  0  0  0  0  0 
 0  0  0  0  0  0 20 20  0  0  0  0  0  0  0  0  0  0 33  0  0  0  0  0  0  0  0  0  0  0  0  0  0  0  0  0  0  0  0  0 
 0  0  0  0  0  0  0  0  0  0  0  0  0  0  0 30 29  0  0  0  0  0  0  0 30 29  0  0  0  0  0  0  0  0  0  0  0  0  0  0 
 0  0  0  0  0  0  0  0  0  0  0  0  0  0  0  0  0  0  0 28  0  0 28  0  0  0  0  0  0  0  0  0  0  0  0  0  0  0  0  0 
 0  0  0  0 20  0  0  0  0  0  0  0  0  0  0  0  0  0  0  0  0  0  0  0  0  0  0  0  0  0  0  0  0  0  0  0  0  0  0  0 
 0  0  0  0  0  0  0  0  0  0  0  0  0  0  0  0  0  0  0  0  0  0  0  0  0  0  0  0  0  0  0  0  0  0  0  0  0  0  0  0 
 0  0  0  0  0  0  0  0  0  0  0  0  0  0  0  0  0  0  0  0  0  0  0  0  0  0  0  0  0  0  0  0  0  0  0  0  0  0  0  0 
 0  0  0  0  0  0  0  0  0  0  0  0  0  0  0  0  0  0  0  0  0  0  0  0  0  0  0  0  0  0  0  0  0  0  0  0  0  0  0  0 
 0  0  0  0 20 20  0  0  0  0  0  0  0  0  0  0  0  0  0  0  0  0  0  0  0  0  0  0  0  0  0  0  0  0  0  0  0  0  0  0 
 0  0  0  0  0  0  0  0  0  0  0  0  0  0  0  0  0  0  0  0  0  0  0  0  0  0  0  0  0  0  0  0  0  0  0  0  0  0  0  0 
 0  0  0  0  0  0  0  0  0  0  0 30  0  0  0  0  0  0  0  0 29  0 25 27  0  0  0  0  0  0  0  0  0  0  0  0  0  0  0  0 
 0  0  0  0  0  0  0  0  0 20 20 20  0  0  0  0  0  0  0  0 19 20 20 20  0  0  0  0  0  0  0  0  0  0  0  0  0  0  0  0 
 0  0  0  0  0  0  0  0  0  0  0  0  0  0  0  0  0  0  0  0  0  0  0  0  0  0  0  0  0  0  0  0  0  0  0  0  0  0  0  0 
 0  0  0  0  0  0  0  0  0  0  0  0  0  0  0  0  0  0  0  0  0  0  0  0  0  0  0  0  0  0  0  0  0  0  0  0  0  0  0  0 
 0  0  0  0 20 20  0  0  0  0  0  0  0  0  0  0  0  0  0  0  0  0  0  0  0  0  0  0 36  0  0  0  0  0  0  0  0  0  0  0 
 0  0  0  0  0  0  0  0  0  0  0  0  0  0  0  0  0  0  0  0  0  0 20 20 20  0  0  0  0  0  0  0  0  0  0  0  0  0  0  0 
 0  0  0  0  0  0  0  0  0  0  0  0  0  0  0  0  0  0  0  0  0  0  0  0  0  0  0  0  0  0  0  0  0  0  0  0  0  0  0  0 
 0  0  0  0  0  0  0  0  0  0  0  0  0  0  0  0  0  0  0  0  0  0  0  0  0  0  0  0  0  0  0  0  0  0  0  0  0  0  0  0 
 0  0  0  0 20 20 20  0  0  0  0  0  0  0  0  0  0  0  0  0  0  0  0  0  0  0 20 20 20 20 20  0  0  0  0  0  0  0  0  0 
 0  0  0  0  0  0  0  0  0  0  0 25 26 27  0  0  0  0  0  0  0  0  0  0  0  0  0  0  0  0  0  0  0  0  0  0  0  0  0  0 
 0  0  0  0  0  0  0  0  0 20 20 20 20 20 20 20 20 20  0  0  0  0 31 31 31 31 31 31 31 31  0  0  0  0  0  0  0  0  0  0 
 0  0  0  0  0  0  0  0  0  0  0  0  0  0  0  0  0  0  0  0  0 31 31 31 31 31 31 31 31 31  0  0  0  0  0  0  0  0  0  0 
 0  0  0  0  0  0  0  0  0  0  0  0  0  0  0  0  0  0  0  0  0 32 31 31 31 31 31 31 31 31  0  0  0  0  0  0  0  0  0  0 
 0  0  0  0 28 25 26 26 26 27  0  0  0  0  0  0  0  0  0  0  0 32 31 31 31 31 31 31 31 31  0  0  0  0  0  0  0  0  0  0 
 0  0  0  0 20 20 20 20 20 20 20 20 20 20 20 20 20 20 20 20 20 20 20 20 20 20 20 20 20  0  0  0  0  0  0  0  0  0  0  0 
 0  0  0  0  0  0  0  0  0  0  0  0  0  0  0  0  0  0  0  0  0  0  0  0  0  0  0  0  0  0  0  0  0  0  0  0  0  0  0  0 
 0  0  0  0  0  0  0  0  0  0  0  0  0  0  0  0  0  0  0  0  0  0  0  0  0  0  0  0  0  0  0  0  0  0  0  0  0  0  0  0 
 0  0  0  0  0  0  0  0  0  0  0  0  0  0  0  0  0  0  0  0  0  0  0  0  0  0  0  0  0  0  0  0  0  0  0  0  0  0  0  0 
Player 960 2458
Skeleton 1514 2754
Skeleton1 1977.34 2754
Item 1100 350
